+--+--+--+--+--+
|           |  |
+  +--+--+  +  +
|  |     |     |
+  +--+  +--+  +
|     |     |  |
+--+  +--+  +  +
|     |  |     |
+  +--+  +  +--+
|        |     | 
+--+--+--+--+--+