+--+r-+r-+--+--+
|           r  g
+  +r-+--+  +  +
|  |     |     |
+  +--+  +--+  +
r     |     |  |
+--+  +--+  +  +
g     |  |     |
+  +--+  +  +--+
|        |    .d 
+--+--+c-+w-+--+